..............................#.####.....
..............................#.....#....
.......###...............########.#.##...
......#   #.............#.......#.#...#..
......# # ##............#.#####.#####.#..
......# #   #...........#.....#.#.....#..
.###### ### #............####.#.#.####...
#       #.# #...............#.#...#......
# #######.# ######..........#.####.......
# #..   #.# #     #.........#.#...#......
# #.# # #.# # ### ####......#.#.#.#......
# #.# #   #   #.#    D#.....#...#.#......
# ### ### #####.#################.#......
#     #.#   #   #..           #...#......
.######.### # # ### ######### #.##.......
#       ..#   #     #.....#   #.#........
# ##### #.###########....## ###.##.......
#   #.# #...#       ....#   #.....#......
.## #.# ##### ##### #...# ###.###.#......
#   #.#       #.#   #...# #.....#.#......
# ###.#####.###.# ##....# #####.#.#......
#   #.#   #.....# #.....#     #.#.#......
.## #.# # ####### ...######## #.#.##.....
.O# ..# #         #.#     #   #.#...#....
# # ### #########...# ### # #######.####.
# # #   #...........# #.#   #.....#.#...#
# # # ##............# #.#######.#.#.#.#.#
# # #   #...........#     #...#.#.#...#.#
# # ### ##.###...######## #.#.#.#.#####.#
# #   #   #   #.#   ....# #.#...#.......#
# ### ### # # ### # ##### #.###########.#
#     ..#   #     #       ..#...........#
.#######.###.#####.#########.###########.
-------248!
