.#######.###.#####.#########.###########.
#.......#...#.....#.........#...........#
#.###.###.#.#.###.#.#####.#.###########.#
#.#...#...#...#.#.......#.#.#...#.......#
#.#.###.##.###...########.#.#.#.#.#####.#
#.#.#...#...........#.....#...#.#.#...#.#
#.#.#.##............#.#.#######.#.#.#.#.#
#.#.#...#...........#.#.#...#.....#.#...#
#.#.###.#########...#.###.#.#######.####.
.O#...#.#.........#.#.....#...#.#...#....
.##.#.#.#.#######....########.#.#.##.....
#...#.#...#.....#.#.....#.....#.#.#......
#.###.#####.###.#.##....#.#####.#.#......
#...#.#.......#.#...#...#.#.....#.#......
.##.#.#.#####.#####.#...#.###.###.#......
#...#.#.#...#...........#...#.....#......
#.#####.#.###########....##.###.##.......
#.........#...#.....#.....#...#.#........
.######.###.#.#.###.#########.#.##.......
#.....#.#...#...#.............#...#......
#.###.###.#####.#################.#......
#.#.#.#...#...#.#....D#.....#...#.#......
#.#.#.#.#.#.#.###.####......#.#.#.#......
#.#.....#.#.#.....#.........#.#...#......
#.#######.#.######..........#.####.......
#.......#.#.#...............#.#...#......
.######.###.#............####.#.#.####...
......#.#...#...........#.....#.#.....#..
......#.#.##............#.#####.#####.#..
......#...#.............#.......#.#...#..
.......###...............########.#.##...
..............................#.....#....
..............................#.####.....
-------248!
