.#######.###.#####.#########.###########.
#.......#...#.....#.........#...........#
#.###.###.#.#.###.#.#####.#.###########.#
#.#...#...#...#.#.......#.#.#...#.......#
#.#.###.#######.#########.#.#.#.#.#####.#
#.#.#...#...#.......#.....#...#.#.#...#.#
#.#.#.###.#.#.#.#####.#.#######.#.#.#.#.#
#.#.#...#.#...#.....#.#.#...#.....#.#...#
#.#.###.###########.#.###.#.#######.####.
#O#...#.#.........#.#.....#...#.#...#...#
.##.#.#.#.#######.#.#########.#.#.###.##.
#...#.#...#.....#.#.....#.....#.#.#.....#
#.###.#####.###.#.###.###.#####.#.#####.#
#...#.#.......#.#...#...#.#.....#.#.....#
.##.#.#.#####.#####.###.#.###.###.#.####.
#...#.#.#...#...........#...#.....#.....#
#.#####.#.#############.###.###.###.###.#
#.........#...#.....#.....#...#.#.....#.#
.######.###.#.#.###.#########.#.#####.#.#
#.....#.#...#...#.............#...#...#.#
#.###.###.#####.#################.#####.#
#.#.#.#...#...#.#....D#.....#...#.#.....#
#.#.#.#.#.#.#.###.#####.###.#.#.#.#.####.
#.#.....#.#.#.....#.....#.#.#.#...#.....#
#.#######.#.#######.#####.#.#.#####.###.#
#.......#.#.#...#.....#.....#.#...#...#.#
.######.###.#.###.###.#######.#.#.#####.#
#.....#.#...#.#...#.#...#.....#.#.....#.#
#.#.###.#.###.#.###.###.#.#####.#####.#.#
#.#...#...#...........#.#.......#.#...#.#
#.###.#####.###########.#########.#.###.#
#...#.....#...#.#.....#.......#.....#...#
.##.###.#.###.#.#.###.#.#######.#####.##.
#.#.#...#...#...#...#...#.....#...#.....#
#.#.#.#########.###.###.#.###.###.#####.#
#...#.........#.#...#...#.#.#.....#...#.#
#.##.########.#.#.###.###.#.#######.#.#.#
#...#.......#...#...#...#...#...#...#.#.#
.##.###.###.#######.#######.#.#.#.###.#.#
#.......#.........#...........#...#.....#
.#######.#########.###########.###.#####.
